завезти - завозить
завезтись - завозиться
ввезти - ввозить
ввезтись - ввозиться
подвезти - подвозить
перевезти - перевозить
перевезтись - перевозиться
развезти - развозить
развезтись - развозиться
привезти - привозить
привезтись - привозиться
провезти - провозить
провезтись - провозиться
свезти - свозить
свезтись - свозиться
отвезти - отвозить
увезти - увозить
вывезти - вывозить
вывезтись - вывозиться
заползти - заползать
наползти - наползать
вползти - вползать
подползти - подползать
сползти - сползать
расползти - расползать
расползтись - расползаться
отползти - отползать
уползти - уползать
выползти - выползать
запасти - запасать
запастись - запасаться
опасти - опасать
опастись - опасаться
спасти - спасать
спастись - спасаться
зарасти - зарастать
нарасти - нарастать
нарастись - наращиваться
обрасти - обрастать
врасти - врастать
подрасти - подрастать
перерасти - перерастать
разрасти - разрастать
разрастись - разрастаться
взрасти - взращивать
возрасти - возрастать
прирасти - прирастать
дорасти - доращивать
прорасти - прорастать
срасти - срастать
срастись - срастаться
отрасти - отращивать
вырасти - вырастать
вырастись - выращиваться
завести - заводить
завестись - заводиться
навести - наводить
навестись - наводиться
обвести - обводить
ввести - вводить
ввестись - вводиться
подвести - подводить
подвестись - подводиться
перевести - переводить
перевестись - переводиться
развести - разводить
развестись - разводиться
извести - изводить
известись - изводиться
возвести - возводить
возвестись - возводиться
привести - приводить
привестись - приводиться
довести - доводить
довестись - доводиться
повести - поводить
провести - проводить
провестись - проводиться
свести - сводить
свестись - сводиться
отвести - отводить
отвестись - отводиться
увести - уводить
зацвести - зацветать
процвести - процветать
расцвести - расцветать
вывести - выводить
вывестись - выводиться
заплести - заплетать
заплестись - заплетаться
вплести - вплетать
вплестись - вплетаться
переплести - переплетать
переплестись - переплетаться
оплести - оплетать
сплести - сплетать
сплестись - сплетаться
расплести - расплетать
уплести - уплетать
замести - заметать
заместись - заметаться
подмести - подметать
размести - разметать
взмести - взметать
смести - сметать
отмести - отметать
вымести - выметать
занести - заносить
занестись - заноситься
нанести - наносить
нанестись - наноситься
обнести - обносить
обнестись - обноситься
внести - вносить
внестись - вноситься
нагнести - нагнетать
угнести - угнетать
поднести - подносить
поднестись - подноситься
перенести - переносить
перенестись - переноситься
разнести - разносить
разнестись - разноситься
изнести - износить
изнестись - износиться
вознести - возносить
вознестись - возноситься
принести - приносить
принестись - приноситься
донести - доносить
донестись - доноситься
понести - поносить
пронести - проносить
пронестись - проноситься
снести - сносить
снестись - сноситься
отнести - относить
отнестись - относиться
унести - уносить
унестись - уноситься
вынести - выносить
вынестись - выноситься
забрести - забредать
разбрести - разбредать
разбрестись - разбредаться
загрести - загребать
подгрести - подгребать
разгрести - разгребать
погрести - погребать
сгрести - сгребать
выгрести - выгребать
перетрясти - перетряхивать
отрясти - отряхивать
отрястись - отряхиваться
потрясти - потряхивать
стрясти - стряхивать
встрясти - встряхивать
вытрясти - вытряхивать
загибать - загибать
загибаться - загибаться
нагибать - нагибать
нагибаться - нагибаться
перегибать - перегибать
разгибать - разгибать
разгибаться - разгибаться
изгибать - изгибать
изгибаться - изгибаться
пригибать - пригибать
пригибаться - пригибаться
огибать - огибать
погибать - погибать
прогибать - прогибать
прогибаться - прогибаться
сгибать - сгибать
сгибаться - сгибаться
выгибать - выгибать
выгибаться - выгибаться
пережевать - пережевывать
разжевать - разжевывать
дожевать - дожевывать
пожевать - пожевывать
прожевать - прожевывать
доклевать - доклевывать
поклевать - поклевывать
склевать - склевывать
выклевать - выклевывать
зазвать - зазывать
назвать - называть
назваться - называться
призвать - призывать
призваться - призываться
обозвать - обзывать
обозваться - обзываться
подозвать - подзывать
позвать - позывать
прозвать - прозывать
прозваться - прозываться
созвать - сзывать
созваться - созываться
отозвать - отзывать
отозваться - отзываться
вызвать - вызывать
вызваться - вызываться
наворачивать - наворотить
поворачивать - поворотить
сворачивать - своротить
наследовать - наследовать
наследоваться - наследоваться
обследовать - обследовать
обследоваться - обследоваться
преследовать - преследовать
преследоваться - преследоваться
последовать - последовать
проследовать - проследовать
расследовать - расследовать
расследоваться - расследоваться
исследовать - исследовать
исследоваться - исследоваться
втолковать - втолковывать
растолковать - растолковывать
истолковать - истолковывать
истолковаться - истолковываться
зацеловать - зацеловывать
нацеловать - нацеловывать
сцеловать - сцеловывать
расцеловать - расцеловывать
заволновать - заволновать
заволноваться - заволноваться
возволновать - взволновать
возволноваться - взволноваться
засовать - засовывать
всовать - всовывать
подсовать - подсовывать
просовать - просовывать
просоваться - просовываться
рассовать - рассовывать
высовать - высовывать
высоваться - высовываться
зарвать - зарывать
зарваться - зарываться
нарвать - нарывать
нарваться - нарываться
перервать - перерывать
перерваться - перерываться
прервать - прерывать
прерваться - прерываться
оборвать - обрывать
оборваться - обрываться
ворвать - врывать
ворваться - врываться
надорвать - надрывать
надорваться - надрываться
подорвать - подрывать
подорваться - подрываться
разорвать - разрывать
разорваться - разрываться
взорвать - взрывать
взорваться - взрываться
порвать - порывать
порваться - порываться
прорвать - прорывать
прорваться - прорываться
сорвать - срывать
сорваться - срываться
оторвать - отрывать
оторваться - отрываться
урвать - урывать
вырвать - вырывать
вырваться - вырываться
перешагать - перешагивать
вышагать - вышагивать
застегать - застегивать
застегаться - застегиваться
настегать - настегивать
подстегать - подстегивать
пристегать - пристегивать
расстегать - расстегивать
расстегаться - расстегиваться
отстегать - отстегивать
подвизгать - подвизгивать
возвизгать - взвизгивать
повизгать - повизгивать
забрызгать - забрызгивать
разбрызгать - разбрызгивать
обрызгать - обрызгивать
сбрызгать - сбрызгивать
полязгать - полязгивать
задвигать - задвигать
надвигать - надвигать
надвигаться - надвигаться
передвигать - передвигать
передвигаться - передвигаться
раздвигать - раздвигать
раздвигаться - раздвигаться
воздвигать - воздвигать
воздвигаться - воздвигаться
придвигать - придвигать
придвигаться - придвигаться
подвигать - подвигать
подвигаться - подвигаться
продвигать - продвигать
продвигаться - продвигаться
отодвигать - отодвигать
отодвигаться - отодвигаться
сдвигать - сдвигать
сдвигаться - сдвигаться
выдвигать - выдвигать
выдвигаться - выдвигаться
подмигать - подмигивать
перемигать - перемигивать
перемигаться - перемигиваться
помигать - помигивать
затрогать - затрагивать
затрогаться - затрагиваться
притрогать - притрагивать
притрогаться - притрагиваться
дотрогать - дотрагивать
дотрогаться - дотрагиваться
потрогать - потрогивать
строгать - страгивать
подмаргать - подмаргивать
помаргать - помаргивать
смаргать - смаргивать
задергать - задергивать
обдергать - обдергивать
поддергать - поддергивать
передергать - передергивать
раздергать - раздергивать
вздергать - вздергивать
одергать - одергивать
подергать - подергивать
подергаться - подергиваться
сдергать - сдергивать
отдергать - отдергивать
выдергать - выдергивать
запугать - запугивать
припугать - припугивать
спугать - спугивать
распугать - распугивать
вспугать - вспугивать
отпугать - отпугивать
обругать - обругивать
поругать - поругивать
состругать - состругивать
усмыгать - усмыгивать
пошмыгать - пошмыгивать
прошмыгать - прошмыгивать
подрыгать - подрыгивать
запрыгать - запрыгивать
подпрыгать - подпрыгивать
заподпрыгать - заподпрыгивать
перепрыгать - перепрыгивать
припрыгать - припрыгивать
попрыгать - попрыгивать
спрыгать - спрыгивать
вспрыгать - вспрыгивать
отпрыгать - отпрыгивать
выпрыгать - выпрыгивать
отрыгать - отрыгивать
ошмурыгать - ошмурыгивать
загадать - загадывать
нагадать - нагадывать
разгадать - разгадывать
отгадать - отгадывать
предугадать - предугадывать
выгадать - выгадывать
задать - задавать
задаться - задаваться
обгладать - обгладывать
выпадать - выпадывать
обкрадать - обкрадывать
скрадать - скрадывать
выкрадать - выкрадывать
обдать - обдавать
вдать - вдавать
вдаться - вдаваться
оправдать - оправдывать
оправдаться - оправдываться
поддать - поддавать
поддаться - поддаваться
обедать - обедывать
заведать - заведывать
разведать - разведывать
проповедать - проповедывать
исповедать - исповедывать
проведать - проведывать
отведать - отведывать
выведать - выведывать
передать - передавать
передаться - передаваться
предать - предавать
предаться - предаваться
подждать - поджидать
переждать - пережидать
ождать - ожидать
ождаться - ожидаться
дождать - дожидать
дождаться - дожидаться
выждать - выжидать
раздать - раздавать
раздаться - раздаваться
издать - издавать
издаться - издаваться
воздать - воздавать
запоздать - запаздывать
опоздать - опаздывать
обуздать - обуздывать
видать - видывать
закидать - закидывать
накидать - накидывать
накидаться - накидываться
подкидать - подкидывать
перекидать - перекидывать
перекидаться - перекидываться
прикидать - прикидывать
прикидаться - прикидываться
поприкидать - поприкидывать
окидать - окидывать
докидать - докидывать
запрокидать - запрокидывать
опрокидать - опрокидывать
опрокидаться - опрокидываться
скидать - скидывать
раскидать - раскидывать
раскидаться - раскидываться
вскидать - вскидывать
вскидаться - вскидываться
откидать - откидывать
откидаться - откидываться
выкидать - выкидывать
повыкидать - повыкидывать
придать - придавать
придаться - придаваться
угодать - угадывать
угодаться - угадываться
подать - подавать
податься - подаваться
обнародать - обнародывать
продать - продавать
продаться - продаваться
попердать - попердывать
сдать - сдавать
сдаться - сдаваться
отдать - отдавать
отдаться - отдаваться
удать - удавать
удаться - удаваться
подудать - подудывать
выдать - выдавать
выдаться - выдаваться
отпрядать - отпрядывать
зажать - зажимать
зажаться - зажиматься
нажать - нажимать
вжать - вжимать
вжаться - вжиматься
поджать - поджимать
забежать - забегать
набежать - набегать
вбежать - вбегать
подбежать - подбегать
перебежать - перебегать
разбежать - разбегать
разбежаться - разбегаться
взбежать - взбегать
избежать - избегать
избежаться - избегаться
прибежать - прибегать
обежать - обегать
побежать - побегать
пробежать - пробегать
сбежать - сбегать
сбежаться - сбегаться
отбежать - отбегать
убежать - убегать
выбежать - выбегать
разлежать - разлеживать
разлежаться - разлеживаться
полежать - полеживать
пролежать - пролеживать
отлежать - отлеживать
отлежаться - отлеживаться
разжать - разжимать
прижать - прижимать
прижаться - прижиматься
пожать - пожимать
вздрожать - вздрагивать
подрожать - подрагивать
задержать - задерживать
задержаться - задерживаться
поддержать - поддерживать
поддержаться - поддерживаться
воздержать - воздерживать
воздержаться - воздерживаться
придержать - придерживать
придержаться - придерживаться
одержать - одерживать
сдержать - сдерживать
сдержаться - сдерживаться
удержать - удерживать
удержаться - удерживаться
выдержать - выдерживать
выдержаться - выдерживаться
сжать - сжимать
сжаться - сжиматься
отжать - отжимать
ужать - ужинать
выжать - выжимать
заказать - заказывать
заказаться - заказываться
наказать - наказывать
наказаться - наказываться
приказать - приказывать
оказать - оказывать
оказаться - оказываться
доказать - доказывать
доказаться - доказываться
показать - показывать
показаться - показываться
сказать - говорить
сказаться - говориться
отказать - отказывать
отказаться - отказываться
указать - указывать
указаться - указываться
предуказать - предуказывать
выказать - выказывать
выказаться - выказываться
замазать - замазывать
намазать - намазывать
намазаться - намазываться
обмазать - обмазывать
вмазать - вмазывать
подмазать - подмазывать
размазать - размазывать
промазать - промазывать
смазать - смазывать
отмазать - отмазывать
отмазаться - отмазываться
вымазать - вымазывать
зализать - зализывать
облизать - облизывать
облизаться - облизываться
подлизать - подлизывать
подлизаться - подлизываться
прилизать - прилизывать
прилизаться - прилизываться
слизать - слизывать
вылизать - вылизывать
позвакать - позвакивать
поддакать - поддакивать
оплакать - оплакивать
поплакать - поплакивать
выплакать - выплакивать
обмакать - обмакивать
промакать - промакивать
прокарабкать - прокарабкивать
прокарабкаться - прокарабкиваться
выкарабкать - выкарабкивать
выкарабкаться - выкарабкиваться
потявкать - потявкивать
окликать - окликивать
вскликать - вскликивать
начирикать - начирикивать
подкрикать - подкрикивать
перекрикать - перекрикивать
перекрикаться - перекрикиваться
прикрикать - прикрикивать
окрикать - окрикивать
покрикать - покрикивать
выкрикать - выкрикивать
похихикать - похихикивать
помалкать - помалкивать
заталкать - заталкивать
наталкать - наталкивать
наталкаться - наталкиваться
вталкать - вталкивать
подталкать - подталкивать
доталкать - доталкивать
проталкать - проталкивать
проталкаться - проталкиваться
сталкать - сталкивать
сталкаться - сталкиваться
отталкать - отталкивать
отталкаться - отталкиваться
выталкать - выталкивать
выталкаться - выталкиваться
защелкать - защелкивать
подщелкать - подщелкивать
прищелкать - прищелкивать
пощелкать - пощелкивать
растолкать - расталкивать
причмокать - причмокивать
подкнокать - подкнокивать
покнокать - покнокивать
покать - покивать
отхаркать - отхаркивать
пришаркать - пришаркивать
посверкать - посверкивать
просверкать - просверкивать
зачеркать - зачеркивать
надчеркать - надчеркивать
подчеркать - подчеркивать
подчеркаться - подчеркиваться
перечеркать - перечеркивать
прочеркать - прочеркивать
вычеркать - вычеркивать
вычеркаться - вычеркиваться
подтутыркать - подтутыркивать
пофыркать - пофыркивать
затаскать - затаскивать
натаскать - натаскивать
втаскать - втаскивать
подтаскать - подтаскивать
перетаскать - перетаскивать
притаскать - притаскивать
потаскать - потаскивать
протаскать - протаскивать
стаскать - стаскивать
растаскать - растаскивать
оттаскать - оттаскивать
утаскать - утаскивать
вытаскать - вытаскивать
взблескать - взблескивать
поблескать - поблескивать
проблескать - проблескивать
отблескать - отблескивать
оплескать - оплескивать
поплескать - поплескивать
расплескать - расплескивать
всплескать - всплескивать
выплескать - выплескивать
выплескаться - выплескиваться
заискать - заискивать
приискать - приискивать
снискать - снискивать
поискать - поискивать
втискать - втискивать
втискаться - втискиваться
притискать - притискивать
потискать - потискивать
стискать - стискивать
оттискать - оттискивать
выискать - выискивать
вспырскать - вспырскивать
обыскать - обыскивать
подыскать - подыскивать
разыскать - разыскивать
разыскаться - разыскиваться
взыскать - взыскивать
взыскаться - взыскиваться
изыскать - изыскивать
изыскаться - изыскиваться
впрыскать - впрыскивать
опрыскать - опрыскивать
спрыскать - спрыскивать
вспрыскать - вспрыскивать
сыскать - сыскивать
отыскать - отыскивать
расплюскать - расплюскивать
поддудукать - поддудукивать
напичкать - напичкивать
подъелдыкать - подъелдыкивать
взмыкать - взмыкивать
похмыкать - похмыкивать
заныкать - заныкивать
отныкать - отныкивать
похныкать - похныкивать
взбрыкать - взбрыкивать
завзбрыкать - завзбрыкивать
порыкать - порыкивать
побулькать - побулькивать
выбулькать - выбулькивать
науськать - науськивать
убаюкать - убаюкивать
назюкать - назюкивать
похрюкать - похрюкивать
присюсюкать - присюсюкивать
потюкать - потюкивать
позвякать - позвякивать
побрякать - побрякивать
покрякать - покрякивать
перемалать - перемалывать
размалать - размалывать
налать - налывать
пропалать - пропалывать
выпалать - выпалывать
оседлать - оседлывать
расседлать - расседлывать
заделать - заделывать
обделать - обделывать
подделать - подделывать
подделаться - подделываться
переделать - переделывать
переделаться - переделываться
разделать - разделывать
разделаться - разделываться
возделать - возделывать
возделаться - возделываться
приделать - приделывать
доделать - доделывать
поделать - поделывать
проделать - проделывать
отделать - отделывать
отделаться - отделываться
уделать - уделывать
выделать - выделывать
выделаться - выделываться
смолать - смалывать
заслать - засылать
наслать - насылать
переслать - пересылать
переслаться - пересылаться
прислать - присылать
послать - посылать
послаться - посылаться
сслать - ссылать
сслаться - ссылаться
расслать - рассылать
расслаться - рассылаться
отслать - отсылать
отслаться - отсылаться
выслать - высылать
выслаться - высылаться
обмать - обмануть
загнать - загонять
загнаться - загоняться
нагнать - нагонять
перегнать - перегонять
перегнаться - перегоняться
изгнать - изгонять
изгнаться - изгоняться
обогнать - обгонять
вогнать - вгонять
догнать - догонять
подогнать - подгонять
разогнать - разгонять
разогнаться - разгоняться
погнать - погонять
прогнать - прогонять
согнать - сгонять
отогнать - отгонять
угнать - угонять
выгнать - выгонять
постонать - постанывать
выстонать - выстанывать
вкапать - вкапывать
подкапать - подкапывать
подкапаться - подкапываться
перекапать - перекапывать
прикапать - прикапывать
окапать - окапывать
окапаться - окапываться
докапать - докапывать
докапаться - докапываться
прокапать - прокапывать
вскапать - вскапывать
процарапать - процарапывать
расцарапать - расцарапывать
исцарапать - исцарапывать
выцарапать - выцарапывать
накрапать - накрапывать
пришлепать - пришлепывать
пошлепать - пошлепывать
всхлипать - всхлипывать
повсхлипать - повсхлипывать
поскрипать - поскрипывать
защипать - защипывать
прищипать - прищипывать
ощипать - ощипывать
пощипать - пощипывать
отщипать - отщипывать
выщипать - выщипывать
закопать - закапывать
закопаться - закапываться
накопать - накапывать
раскопать - раскапывать
откопать - откапывать
выкопать - выкапывать
долопать - долопывать
захлопать - захлопывать
захлопаться - захлопываться
подхлопать - подхлопывать
прихлопать - прихлопывать
охлопать - охлопывать
похлопать - похлопывать
притопать - притопывать
зачерпать - зачерпывать
почерпать - почерпывать
исчерпать - исчерпывать
исчерпаться - исчерпываться
отчерпать - отчерпывать
вычерпать - вычерпывать
подколупать - подколупывать
отколупать - отколупывать
выколупать - выколупывать
нащупать - нащупывать
ощупать - ощупывать
прощупать - прощупывать
прощупаться - прощупываться
засыпать - засыпать
засыпаться - засыпаться
насыпать - насыпать
обсыпать - обсыпать
всыпать - всыпать
подсыпать - подсыпать
пересыпать - пересыпать
присыпать - присыпать
осыпать - осыпать
осыпаться - осыпаться
посыпать - посыпать
посыпаться - посыпаться
просыпать - просыпать
просыпаться - просыпаться
ссыпать - ссыпать
ссыпаться - ссыпаться
рассыпать - рассыпать
рассыпаться - рассыпаться
отсыпать - отсыпать
усыпать - усыпать
высыпать - высыпать
высыпаться - высыпаться
забрать - забирать
забраться - забираться
набрать - набирать
набраться - набираться
вбрать - вбирать
подбрать - подбирать
подбраться - подбираться
перебрать - перебирать
перебраться - перебираться
разбрать - разбирать
разбраться - разбираться
взбрать - взбирать
взбраться - взбираться
избрать - избирать
избраться - избираться
прибрать - прибирать
прибраться - прибираться
добрать - добирать
добраться - добираться
пробрать - пробирать
пробраться - пробираться
собрать - собирать
собраться - собираться
сбрать - сбирать
сбраться - сбираться
отбрать - отбирать
отбраться - отбираться
убрать - убирать
убраться - убираться
выбрать - выбирать
выбраться - выбираться
засасать - засасывать
обсасать - обсасывать
всасать - всасывать
всасаться - всасываться
посасать - посасывать
рассасать - рассасывать
рассасаться - рассасываться
отсасать - отсасывать
обтесать - обтесывать
стесать - стесывать
вытесать - вытесывать
зачесать - зачесывать
причесать - причесывать
причесаться - причесываться
почесать - почесывать
почесаться - почесываться
прочесать - прочесывать
расчесать - расчесывать
расчесаться - расчесываться
вычесать - вычесывать
записать - записывать
записаться - записываться
поназаписать - поназаписывать
перезаписать - перезаписывать
написать - написывать
вписать - вписывать
вписаться - вписываться
надписать - надписывать
предписать - предписывать
предписаться - предписываться
подписать - подписывать
подписаться - подписываться
переписать - переписывать
переписаться - переписываться
приписать - приписывать
приписаться - приписываться
описать - описывать
описаться - описываться
дописать - дописывать
пописать - пописывать
прописать - прописывать
прописаться - прописываться
списать - списывать
списаться - списываться
расписать - расписывать
расписаться - расписываться
исписать - исписывать
отписать - отписывать
уписать - уписывать
выписать - выписывать
выписаться - выписываться
забросать - забрасывать
набросать - набрасывать
набросаться - набрасываться
вбросать - вбрасывать
подбросать - подбрасывать
перебросать - перебрасывать
перебросаться - перебрасываться
разбросать - разбрасывать
разбросаться - разбрасываться
взбросать - взбрасывать
сбросать - сбрасывать
сбросаться - сбрасываться
отбросать - отбрасывать
отбросаться - отбрасываться
выбросать - выбрасывать
выбросаться - выбрасываться
высосать - высасывать
закусать - закусывать
обкусать - обкусывать
надкусать - надкусывать
подкусать - подкусывать
перекусать - перекусывать
прикусать - прикусывать
покусать - покусывать
прокусать - прокусывать
скусать - скусывать
раскусать - раскусывать
откусать - откусывать
выкусать - выкусывать
подплясать - подплясывать
приплясать - приплясывать
заприплясать - заприплясывать
поплясать - поплясывать
отплясать - отплясывать
подпоясать - подпоясывать
перепоясать - перепоясывать
перепоясаться - перепоясываться
опоясать - опоясывать
потрясать - потрясывать
захватать - захватывать
захвататься - захватываться
обхватать - обхватывать
подхватать - подхватывать
перехватать - перехватывать
перехвататься - перехватываться
прихватать - прихватывать
охватать - охватывать
охвататься - охватываться
похватать - похватывать
схватать - схватывать
схвататься - схватываться
расхватать - расхватывать
отхватать - отхватывать
ухватать - ухватывать
ухвататься - ухватываться
выхватать - выхватывать
закатать - закатывать
закататься - закатываться
накатать - накатывать
накататься - накатываться
обкатать - обкатывать
вкатать - вкатывать
подкатать - подкатывать
перекатать - перекатывать
перекататься - перекатываться
окатать - окатывать
прокатать - прокатывать
прокататься - прокатываться
скатать - скатывать
скататься - скатываться
раскатать - раскатывать
откатать - откатывать
откататься - откатываться
выкатать - выкатывать
выкататься - выкатываться
навыкатать - навыкатывать
сглатать - сглатывать
заматать - заматывать
замататься - заматываться
обматать - обматывать
перематать - перематывать
изматать - изматывать
наборматать - наборматывать
отматать - отматывать
отмататься - отматываться
уматать - уматывать
похохатать - похохатывать
запечатать - запечатывать
впечатать - впечатывать
надпечатать - надпечатывать
перепечатать - перепечатывать
припечатать - припечатывать
опечатать - опечатывать
допечатать - допечатывать
распечатать - распечатывать
отпечатать - отпечатывать
пошатать - пошатывать
пошататься - пошатываться
расшатать - расшатывать
расшататься - расшатываться
присоветать - присоветывать
отсоветать - отсоветывать
наметать - наметывать
разметать - разметывать
взметать - взметывать
сметать - сметывать
выметать - выметывать
улепетать - улепетывать
запитать - запитывать
напитать - напитывать
впитать - впитывать
впитаться - впитываться
подпитать - подпитывать
подпитаться - подпитываться
пропитать - пропитывать
пропитаться - пропитываться
воспитать - воспитывать
воспитаться - воспитываться
перевоспитать - перевоспитывать
повоспитать - повоспитывать
зачитать - зачитывать
зачитаться - зачитываться
начитать - начитывать
вчитать - вчитывать
вчитаться - вчитываться
перечитать - перечитывать
причитать - причитывать
дочитать - дочитывать
почитать - почитывать
прочитать - прочитывать
считать - считывать
отчитать - отчитывать
отчитаться - отчитываться
вычитать - вычитывать
взбалтать - взбалтывать
убалтать - убалтывать
наболтать - набалтывать
выболтать - выбалтывать
заработать - зарабатывать
наработать - нарабатывать
обработать - обрабатывать
обработаться - обрабатываться
подработать - подрабатывать
переработать - перерабатывать
переработаться - перерабатываться
разработать - разрабатывать
разработаться - разрабатываться
приработать - прирабатывать
доработать - дорабатывать
доработаться - дорабатываться
проработать - прорабатывать
проработаться - прорабатываться
сработать - срабатывать
отработать - отрабатывать
отработаться - отрабатываться
выработать - вырабатывать
выработаться - вырабатываться
заглотать - заглатывать
проглотать - проглатывать
намотать - наматывать
намотаться - наматываться
размотать - разматывать
размотаться - разматываться
промотать - проматывать
пробормотать - проборматывать
смотать - сматывать
смотаться - сматываться
вымотать - выматывать
втаптать - втаптывать
протаптать - протаптывать
вытаптать - вытаптывать
нашептать - нашептывать
дошептать - дошептывать
пошептать - пошептывать
затоптать - затаптывать
подтоптать - подтоптывать
притоптать - притоптывать
отоптать - отаптывать
стоптать - стаптывать
растоптать - растаптывать
обертать - обертывать
захлестать - захлестывать
нахлестать - нахлестывать
обхлестать - обхлестывать
подхлестать - подхлестывать
перехлестать - перехлестывать
охлестать - охлестывать
ухлестать - ухлестывать
выхлестать - выхлестывать
закутать - закутывать
закутаться - закутываться
окутать - окутывать
окутаться - окутываться
раскутать - раскутывать
укутать - укутывать
запутать - запутывать
запутаться - запутываться
впутать - впутывать
впутаться - впутываться
опутать - опутывать
спутать - спутывать
распутать - распутывать
распутаться - распутываться
выпутать - выпутывать
выпутаться - выпутываться
покряхтать - покряхтывать
запытать - запытывать
допытать - допытывать
допытаться - допытываться
испытать - испытывать
испытаться - испытываться
выпытать - выпытывать
запрятать - запрятывать
перепрятать - перепрятывать
припрятать - припрятывать
спрятать - спрятывать
упрятать - упрятывать
намахать - намахивать
обмахать - обмахивать
обмахаться - обмахиваться
подмахать - подмахивать
перемахать - перемахивать
размахать - размахивать
взмахать - взмахивать
помахать - помахивать
смахать - смахивать
отмахать - отмахивать
отмахаться - отмахиваться
запахать - запахивать
впахать - впахивать
перепахать - перепахивать
припахать - припахивать
попахать - попахивать
пропахать - пропахивать
распахать - распахивать
распахаться - распахиваться
вспахать - вспахивать
потрахать - потрахивать
сахать - сахивать
заехать - заезжать
наехать - наезжать
переехать - переезжать
приехать - приезжать
доехать - доезжать
проехать - проезжать
побрехать - побрехивать
уехать - уезжать
подъехать - подъезжать
разъехать - разъезжать
разъехаться - разъезжаться
съехать - съезжать
съехаться - съезжаться
отъехать - отъезжать
выехать - выезжать
запихать - запихивать
напихать - напихивать
впихать - впихивать
пропихать - пропихивать
спихать - спихивать
распихать - распихивать
отпихать - отпихивать
выпихать - выпихивать
почихать - почихивать
угрохать - угрохивать
впархать - впархивать
перепархать - перепархивать
спархать - спархивать
вспархать - вспархивать
упархать - упархивать
выпархать - выпархивать
пошурхать - пошурхивать
повздыхать - повздыхивать
погромыхать - погромыхивать
попыхать - попыхивать
вспыхать - вспыхивать
занюхать - занюхивать
обнюхать - обнюхивать
разнюхать - разнюхивать
понюхать - понюхивать
вынюхать - вынюхивать
отбацать - отбацывать
зачать - закивать
закачать - закачивать
накачать - накачивать
накачаться - накачиваться
вкачать - вкачивать
подкачать - подкачивать
перекачать - перекачивать
покачать - покачивать
покачаться - покачиваться
прокачать - прокачивать
скачать - скачивать
раскачать - раскачивать
раскачаться - раскачиваться
откачать - откачивать
укачать - укачивать
выкачать - выкачивать
вскричать - вскрикивать
обстучать - обстукивать
перестучать - перестукивать
перестучаться - перестукиваться
пристучать - пристукивать
постучать - постукивать
простучать - простукивать
отстучать - отстукивать
выстучать - выстукивать
замешать - замешивать
замешаться - замешиваться
вмешать - вмешивать
вмешаться - вмешиваться
подмешать - подмешивать
подмешаться - подмешиваться
перемешать - перемешивать
перемешаться - перемешиваться
размешать - размешивать
примешать - примешивать
примешаться - примешиваться
помешать - помешивать
смешать - смешивать
смешаться - смешиваться
вымешать - вымешивать
слышать - слыхивать
потрещать - потрескивать
запищать - запискивать
попищать - попискивать
пропищать - пропискивать
задеть - задевать
поддеть - поддевать
раздеть - раздевать
раздеться - раздеваться
издеть - издевать
издеться - издеваться
воздеть - воздевать
одеть - одевать
одеться - одеваться
заглядеть - заглядывать
заглядеться - заглядываться
вглядеть - вглядывать
вглядеться - вглядываться
подглядеть - подглядывать
переглядеть - переглядывать
переглядеться - переглядываться
разглядеть - разглядывать
взглядеть - взглядывать
приглядеть - приглядывать
приглядеться - приглядываться
оглядеть - оглядывать
оглядеться - оглядываться
доглядеть - доглядывать
поглядеть - поглядывать
проглядеть - проглядывать
проглядеться - проглядываться
выглядеть - выглядывать
зазвенеть - зазвенивать
позвенеть - позвенивать
прихрапеть - прихрапывать
похрапеть - похрапывать
всхрапеть - всхрапывать
вскипеть - вскипать
захрипеть - захрипывать
похрипеть - похрипывать
прохрипеть - прохрипывать
нагреть - нагревать
нагреться - нагреваться
пригреть - пригревать
обогреть - обогревать
обогреться - обогреваться
прогреть - прогревать
прогреться - прогреваться
согреть - согревать
согреться - согреваться
замереть - замирать
обмереть - обмирать
помереть - помирать
отмереть - отмирать
умереть - умирать
вымереть - вымирать
натереть - натирать
обтереть - обтирать
втереть - втирать
потереть - потирать
протереть - протирать
стереть - стирать
стереться - стираться
растереть - растирать
оттереть - оттирать
утереть - утирать
вытереть - вытирать
вытереться - вытираться
назреть - назревать
надзреть - надзирать
презреть - презирать
озреть - озирать
озреться - озираться
обозреть - обозревать
дозреть - дозревать
прозреть - прозревать
созреть - созревать
вызреть - вызревать
загореть - загорать
загореться - загораться
разгореть - разгорать
разгореться - разгораться
возгореть - возгорать
возгореться - возгораться
догореть - догорать
сгореть - сгорать
выгореть - выгорать
засмотреть - засматривать
обсмотреть - обсматривать
всмотреть - всматривать
всмотреться - всматриваться
надсмотреть - надсматривать
подсмотреть - подсматривать
пересмотреть - пересматривать
пересмотреться - пересматриваться
присмотреть - присматривать
присмотреться - присматриваться
осмотреть - осматривать
осмотреться - осматриваться
досмотреть - досматривать
посмотреть - посматривать
просмотреть - просматривать
просмотреться - просматриваться
рассмотреть - рассматривать
рассмотреться - рассматриваться
отсмотреть - отсматривать
усмотреть - усматривать
усмотреться - усматриваться
предусмотреть - предусматривать
предусмотреться - предусматриваться
высмотреть - высматривать
залететь - залетать
налететь - налетать
облететь - облетать
влететь - влетать
подлететь - подлетать
перелететь - перелетать
разлететь - разлетать
разлететься - разлетаться
взлететь - взлетать
прилететь - прилетать
долететь - долетать
пролететь - пролетать
слететь - слетать
слететься - слетаться
улететь - улетать
вылететь - вылетать
завертеть - завертывать
навертеть - навертывать
обвертеть - обвертывать
ввертеть - ввертывать
подвертеть - подвертывать
перевертеть - перевертывать
развертеть - развертывать
развертеться - развертываться
привертеть - привертывать
повертеть - повертывать
свертеть - свертывать
свертеться - свертываться
увертеть - увертывать
увертеться - увертываться
вывертеть - вывертывать
залезть - залезать
влезть - влезать
перелезть - перелезать
пролезть - пролезать
слезть - слезать
вылезть - вылезать
вгрызть - вгрызать
вгрызться - вгрызаться
огрызть - огрызать
огрызться - огрызаться
облаить - облаивать
взлаить - взлаивать
подслаить - подслаивать
прослаить - прослаивать
вылаить - вылаивать
подпаить - подпаивать
припаить - припаивать
опаить - опаивать
спаить - спаивать
спаиться - спаиваться
отпаить - отпаивать
выпаить - выпаивать
задраить - задраивать
надраить - надраивать
перекраить - перекраивать
затаить - затаивать
подтаить - подтаивать
дотаить - дотаивать
протаить - протаивать
стаить - стаивать
растаить - растаять
истаить - истаивать
оттаить - оттаивать
утаить - утаивать
вытаить - вытаивать
охаить - охаивать
забить - забивать
забиться - забиваться
ослабить - ослаблять
ослабиться - ослабляться
набить - набивать
набиться - набиваться
оббить - оббивать
вбить - вбивать
подбить - подбивать
перебить - перебивать
перебиться - перебиваться
потребить - потреблять
потребиться - потребляться
истребить - истреблять
разбить - разбивать
разбиться - разбиваться
взбить - взбивать
избить - избивать
прибить - прибивать
прибиться - прибиваться
ошибить - ошибать
ошибиться - ошибаться
сшибить - сшибать
вышибить - вышибать
вдолбить - вдалбливать
вдолбиться - вдалбливаться
выдолбить - выдалбливать
обить - обивать
обиться - обиваться
добить - добивать
добиться - добиваться
уподобить - уподоблять
уподобиться - уподобляться
побить - побивать
пробить - пробивать
пробиться - пробиваться
оскорбить - оскорблять
оскорбиться - оскорбляться
сбить - сбивать
сбиться - сбиваться
отбить - отбивать
отбиться - отбиваться
убить - убивать
убиться - убиваться
углубить - углублять
углубиться - углубляться
разрубить - разрубать
срубить - срубать
отрубить - отрубать
вырубить - вырубать
вырубиться - вырубаться
выбить - выбивать
выбиться - выбиваться
разбавить - разбавлять
избавить - избавлять
избавиться - избавляться
прибавить - прибавлять
прибавиться - прибавляться
добавить - добавлять
добавиться - добавляться
сбавить - сбавлять
завить - завивать
завиться - завиваться
возглавить - возглавлять
возглавиться - возглавляться
прославить - прославлять
прославиться - прославляться
навить - навивать
навиться - навиваться
поздравить - поздравлять
направить - направлять
направиться - направляться
перенаправить - перенаправлять
вправить - вправлять
переправить - переправлять
переправиться - переправляться
поправить - поправлять
поправиться - поправляться
справить - справлять
справиться - справляться
расправить - расправлять
расправиться - расправляться
исправить - исправлять
исправиться - исправляться
отправить - отправлять
отправиться - отправляться
отравить - отравлять
отравиться - отравляться
заставить - заставлять
наставить - наставлять
обставить - обставлять
вставить - вставлять
вставиться - вставляться
представить - представлять
представиться - представляться
подставить - подставлять
подставиться - подставляться
приставить - приставлять
приставиться - приставляться
оставить - оставлять
оставиться - оставляться
доставить - доставлять
доставиться - доставляться
предоставить - предоставлять
предоставиться - предоставляться
поставить - поставлять
поставиться - поставляться
противопоставить - противопоставлять
противопоставиться - противопоставляться
сопоставить - сопоставлять
сопоставиться - сопоставляться
составить - составлять
составиться - составляться
расставить - расставлять
отставить - отставлять
выставить - выставлять
выставиться - выставляться
обвить - обвивать
обвиться - обвиваться
перевить - перевивать
воодушевить - воодушевлять
развить - развивать
развиться - развиваться
извить - извивать
извиться - извиваться
возвить - взвивать
возвиться - взвиваться
оживить - оживлять
оживиться - оживляться
привить - прививать
привиться - прививаться
постановить - постановлять
восстановить - восстановлять
обновить - обновлять
обновиться - обновляться
возобновить - возобновлять
возобновиться - возобновляться
вдохновить - вдохновлять
вдохновиться - вдохновляться
усыновить - усыновлять
подготовить - подготовлять
подготовиться - подготовляться
изготовить - изготовлять
изготовиться - изготовляться
приготовить - приготовлять
приготовиться - приготовляться
свить - свивать
разветвить - разветвлять
разветвиться - разветвляться
ответвить - ответвлять
ответвиться - ответвляться
отождествить - отождествлять
отождествиться - отождествляться
осуществить - осуществлять
осуществиться - осуществляться
увить - увивать
увиться - увиваться
заявить - заявлять
заявиться - заявляться
проявить - проявлять
проявиться - проявляться
объявить - объявлять
объявиться - объявляться
предъявить - предъявлять
предъявиться - предъявляться
изъявить - изъявлять
выявить - выявлять
выявиться - выявляться
наладить - налаживать
наладиться - налаживаться
загладить - заглаживать
погладить - поглаживать
сгладить - сглаживать
сгладиться - сглаживаться
уладить - улаживать
засадить - засаживать
насадить - насаживать
насадиться - насаживаться
всадить - всаживать
пересадить - пересаживать
пересадиться - пересаживаться
осадить - осаживать
усадить - усаживать
усадиться - усаживаться
высадить - высаживать
высадиться - высаживаться
выпроводить - выпроваживать
зародить - зарождать
зародиться - зарождаться
народить - нарождать
народиться - нарождаться
переродить - перерождать
переродиться - перерождаться
возродить - возрождать
возродиться - возрождаться
загородить - загораживать
облагородить - облагораживать
породить - порождать
выродить - вырождать
выродиться - вырождаться
заходить - захаживать
обходить - обхаживать
оходить - охаживать
походить - похаживать
проходить - прохаживать
проходиться - прохаживаться
расходить - расхаживать
исходить - исхаживать
отходить - отхаживать
отходиться - отхаживаться
уходить - ухаживать
выходить - выхаживать
возбудить - возбуждать
возбудиться - возбуждаться
побудить - побуждать
пробудить - пробуждать
пробудиться - пробуждаться
зарядить - заряжать
зарядиться - заряжаться
нарядить - наряжать
нарядиться - наряжаться
обрядить - обряжать
разрядить - разряжать
разрядиться - разряжаться
развеить - развеивать
развеиться - развеиваться
повеить - повеивать
взлелеить - взлелеивать
заклеить - заклеивать
наклеить - наклеивать
наклеиться - наклеиваться
обклеить - обклеивать
вклеить - вклеивать
подклеить - подклеивать
переклеить - переклеивать
приклеить - приклеивать
приклеиться - приклеиваться
оклеить - оклеивать
проклеить - проклеивать
склеить - склеивать
склеиться - склеиваться
расклеить - расклеивать
осмеить - осмеивать
просмеить - просмеивать
высмеить - высмеивать
высмеиться - высмеиваться
засеить - засеивать
просеить - просеивать
отсеить - отсеивать
усеить - усеивать
высеить - высеивать
затеить - затеять
спроважить - спроваживать
загажить - загаживать
обгажить - обгаживать
зажить - заживать
переналажить - переналаживать
увлажить - увлаживать
наглажить - наглаживать
разглажить - разглаживать
разглажиться - разглаживаться
приглажить - приглаживать
оглажить - оглаживать
отглажить - отглаживать
углажить - углаживать
выглажить - выглаживать
замолажить - замолаживать
омолажить - омолаживать
охолажить - охолаживать
расхолажить - расхолаживать
нажить - наживать
нажиться - наживаться
обеззаражить - обеззараживать
подбражить - подбраживать
обезображить - обезображивать
сбражить - сбраживать
сбражиться - сбраживаться
створажить - створаживать
перегоражить - перегораживать
пригоражить - пригораживать
огоражить - огораживать
огоражиться - огораживаться
отгоражить - отгораживать
отгоражиться - отгораживаться
выгоражить - выгораживать
взбудоражить - взбудораживать
наморажить - намораживать
подморажить - подмораживать
переморажить - перемораживать
разморажить - размораживать
приморажить - примораживать
выморажить - вымораживать
высторажить - выстораживать
обескуражить - обескураживать
надсажить - надсаживать
подсажить - подсаживать
подсажиться - подсаживаться
просажить - просаживать
ссажить - ссаживать
рассажить - рассаживать
рассажиться - рассаживаться
отсажить - отсаживать
обжить - обживать
обжиться - обживаться
поджить - подживать
поежить - поеживать
поежиться - поеживаться
съежить - съеживать
съежиться - съеживаться
изжить - изживать
размозжить - размазживать
обездвижить - обездвиживать
прижить - приживать
прижиться - приживаться
сижить - сиживать
насижить - насиживать
подсижить - подсиживать
пересижить - пересиживать
досижить - досиживать
посижить - посиживать
просижить - просиживать
отсижить - отсиживать
отсижиться - отсиживаться
высижить - высиживать
одолжить - одалживать
ожить - оживать
унавожить - унавоживать
обезвожить - обезвоживать
дожить - доживать
подложить - подлаживать
подложиться - подлаживаться
переложить - перелаживать
разложить - разлаживать
разложиться - разлаживаться
приложить - прилаживать
приложиться - прилаживаться
отложить - отлаживать
стреножить - стреноживать
пожить - поживать
заворожить - завораживать
насторожить - настораживать
насторожиться - настораживаться
прожить - проживать
прожиться - проживаться
подытожить - подытоживать
сжить - сживать
сжиться - сживаться
отжить - отживать
заужить - зауживать
подзужить - подзуживать
раззужить - раззуживать
заслужить - заслуживать
обслужить - обслуживать
обслужиться - обслуживаться
прислужить - прислуживать
отслужить - отслуживать
услужить - услуживать
обнаружить - обнаруживать
обнаружиться - обнаруживаться
обезоружить - обезоруживать
запружить - запруживать
вспружить - вспруживать
сужить - суживать
обсужить - обсуживать
пересужить - пересуживать
удосужить - удосуживать
ссужить - ссуживать
выужить - выуживать
выжить - выживать
запыжить - запыживать
заразить - заражать
заразиться - заражаться
подразить - подражать
разразить - разражать
разразиться - разражаться
возразить - возражать
поразить - поражать
поразиться - поражаться
сразить - сражать
сразиться - сражаться
отразить - отражать
отразиться - отражаться
выразить - выражать
выразиться - выражаться
привозить - приваживать
отвозить - отваживать
отвозиться - отваживаться
вывозить - вываживать
затормозить - затормаживать
притормозить - притормаживать
заморозить - замораживать
загрузить - загружать
загрузиться - загружаться
нагрузить - нагружать
перегрузить - перегружать
разгрузить - разгружать
разгрузиться - разгружаться
погрузить - погружать
погрузиться - погружаться
выгрузить - выгружать
выгрузиться - выгружаться
повлиить - повлиять
засиить - засиять
просиить - просиять
воссиить - воссиять
скить - скивать
завалить - заваливать
завалиться - заваливаться
навалить - наваливать
навалиться - наваливаться
обвалить - обваливать
обвалиться - обваливаться
ввалить - вваливать
ввалиться - вваливаться
перевалить - переваливать
перевалиться - переваливаться
развалить - разваливать
развалиться - разваливаться
возвалить - взваливать
привалить - приваливать
провалить - проваливать
провалиться - проваливаться
свалить - сваливать
свалиться - сваливаться
отвалить - отваливать
отвалиться - отваливаться
увалить - уваливать
увалиться - уваливаться
нахвалить - нахваливать
похвалить - похваливать
расхвалить - расхваливать
восхвалить - восхвалять
вывалить - вываливать
вывалиться - вываливаться
отдалить - отдалять
отдалиться - отдаляться
удалить - удалять
удалиться - удаляться
залить - заливать
залиться - заливаться
закалить - закалять
закалиться - закаляться
накалить - накалять
накалиться - накаляться
умалить - умалять
умалиться - умаляться
налить - наливать
налиться - наливаться
распалить - распалять
распалиться - распаляться
расслаблить - расслаблять
расслаблиться - расслабляться
облить - обливать
облиться - обливаться
обособлить - обособлять
обособлиться - обособляться
влить - вливать
влиться - вливаться
забавлить - забавлять
забавлиться - забавляться
заправлить - заправлять
заправлиться - заправляться
подправлить - подправлять
приправлить - приправлять
оправлить - оправлять
оправлиться - оправляться
управлить - управлять
управлиться - управляться
растравлить - растравлять
переставлить - переставлять
заготовлить - заготовлять
обожествлить - обожествлять
умерщвлить - умерщвлять
округлить - округлять
замедлить - замедлять
замедлиться - замедляться
подлить - подливать
наделить - наделять
наделиться - наделяться
определить - определять
определиться - определяться
предопределить - предопределять
распределить - распределять
распределиться - распределяться
перераспределить - перераспределять
разделить - разделять
разделиться - разделяться
подразделить - подразделять
подразделиться - подразделяться
отделить - отделять
отделиться - отделяться
уделить - уделять
уделиться - уделяться
выделить - выделять
выделиться - выделяться
испепелить - испепелять
перелить - переливать
перелиться - переливаться
заселить - заселять
заселиться - заселяться
населить - населять
переселить - переселять
переселиться - переселяться
поселить - поселять
поселиться - поселяться
расселить - расселять
расселиться - расселяться
выселить - выселять
нацелить - нацеливать
нацелиться - нацеливаться
прицелить - прицеливать
прицелиться - прицеливаться
исцелить - исцелять
уцелить - уцеливать
выцелить - выцеливать
разлить - разливать
разлиться - разливаться
излить - изливать
излиться - изливаться
умилить - умилять
умилиться - умиляться
прилить - приливать
обрамлить - обрамлять
ущемлить - ущемлять
окаймлить - окаймлять
окаймлиться - окаймляться
преломлить - преломлять
окормлить - окормлять
дозволить - дозволять
дозволиться - дозволяться
позволить - позволять
позволиться - позволяться
долить - доливать
долиться - доливаться
полить - поливать
политься - поливаться
пролить - проливать
пролиться - проливаться
утолить - утолять
окроплить - окроплять
просверлить - просверливать
высверлить - высверливать
слить - сливать
слиться - сливаться
окислить - окислять
перечислить - перечислять
перечислиться - перечисляться
причислить - причислять
причислиться - причисляться
исчислить - исчислять
исчислиться - исчисляться
вычислить - вычислять
вычислиться - вычисляться
впечатлить - впечатлять
отлить - отливать
замышлить - замышлять
размышлить - размышлять
помышлить - помышлять
промышлить - промышлять
вылить - выливать
вылиться - выливаться
доковылить - доковылять
распылить - распылять
окрылить - окрылять
подмить - подмять
устремить - устремлять
устремиться - устремляться
размить - размять
размиться - размяться
уведомить - уведомлять
ошеломить - ошеломлять
утомить - утомлять
утомиться - утомляться
оформить - оформлять
оформиться - оформляться
вразумить - вразумлять
изумить - изумлять
изумиться - изумляться
распрямить - распрямлять
распрямиться - распрямляться
выпрямить - выпрямлять
выпрямиться - выпрямляться
сварганить - сварганивать
вызюганить - вызюганивать
перечеканить - перечеканивать
отчеканить - отчеканивать
заарканить - заарканивать
заманить - заманивать
подманить - подманивать
переманить - переманивать
приманить - приманивать
сманить - сманивать
выманить - выманивать
притаранить - притаранивать
побранить - побранивать
захоранить - захоранивать
распространить - распространять
распространиться - распространяться
отстранить - отстранять
отстраниться - отстраняться
устранить - устранять
устраниться - устраняться
охранить - охранять
охраниться - охраняться
предохранить - предохранять
сохранить - сохранять
сохраниться - сохраняться
приравнить - приравнять
поравнить - поравнять
поравниться - поравняться
сравнить - сравнять
сравниться - сравняться
уравнить - уравнять
выровнить - выровнять
выровниться - выровняться
загнить - загнивать
изгнить - изгнивать
догнить - догнивать
подогнить - подгнивать
согнить - сгнивать
упразднить - упразднять
упраздниться - упраздняться
наводнить - наводнять
приподнить - приподнять
приподниться - приподняться
затруднить - затруднять
затрудниться - затрудняться
расчленить - расчленять
заменить - заменять
замениться - заменяться
воспламенить - воспламенять
воспламениться - воспламеняться
обменить - обменять
обмениться - обменяться
вменить - вменять
вмениться - вменяться
подменить - подменять
подмениться - подменяться
обременить - обременять
переменить - переменять
разменить - разменять
размениться - размениваться
изменить - изменять
измениться - изменяться
видоизменить - видоизменять
видоизмениться - видоизменяться
применить - применять
примениться - применяться
поменить - поменять
помениться - поменяться
променить - променять
сменить - сменять
смениться - сменяться
отменить - отменять
отмениться - отменяться
выменить - выменивать
вымениться - вымениваться
вспенить - вспенивать
искоренить - искоренять
осенить - осенять
затенить - затенять
оттенить - оттенять
оценить - оценивать
оцениться - оцениваться
переоценить - переоценивать
переоцениться - переоцениваться
расценить - расценивать
расцениться - расцениваться
обесценить - обесценивать
обесцениться - обесцениваться
увлажнить - увлажнять
осложнить - осложнять
осложниться - осложняться
усложнить - усложнять
усложниться - усложняться
опорожнить - опорожнять
соблазнить - соблазнять
задразнить - задразнивать
поддразнить - поддразнивать
передразнить - передразнивать
разрознить - разрознивать
загрязнить - загрязнять
загрязниться - загрязняться
обвинить - обвинять
обвиниться - обвиняться
извинить - извинять
извиниться - извиняться
соединить - соединять
соединиться - соединяться
присоединить - присоединять
присоединиться - присоединяться
объединить - объединять
объединиться - объединяться
разъединить - разъединять
разъединиться - разъединяться
напружинить - напружинивать
удлинить - удлинять
удлиниться - удлиняться
заклинить - заклинивать
вклинить - вклинивать
вклиниться - вклиниваться
слинить - слинять
предпринить - предпринять
воспринить - воспринять
подчинить - подчинять
подчиниться - подчиняться
причинить - причинять
сочинить - сочинять
сочиниться - сочиняться
учинить - учинять
заполнить - заполнять
заполниться - заполняться
наполнить - наполнять
наполниться - наполняться
переполнить - переполнять
переполниться - переполняться
дополнить - дополнять
дополниться - дополняться
пополнить - пополнять
пополниться - пополняться
исполнить - исполнять
исполниться - исполняться
преисполнить - преисполнять
преисполниться - преисполняться
восполнить - восполнять
восполниться - восполняться
выполнить - выполнять
выполниться - выполняться
затемнить - затемнять
запомнить - запоминать
запомниться - запоминаться
напомнить - напоминать
припомнить - припоминать
вспомнить - вспоминать
вспомниться - вспоминаться
упомнить - упоминать
упомниться - упоминаться
назвонить - названивать
перезвонить - перезванивать
обозвонить - обзванивать
дозвонить - дозванивать
дозвониться - дозваниваться
позвонить - позванивать
созвонить - созванивать
созвониться - созваниваться
провонить - провонять
урезонить - урезонивать
узаконить - узаконивать
наклонить - наклонять
наклониться - наклоняться
преклонить - преклонять
преклониться - преклоняться
склонить - склонять
склониться - склоняться
отклонить - отклонять
отклониться - отклоняться
заслонить - заслонять
прислонить - прислонять
прислониться - прислоняться
проронить - проранивать
осквернить - осквернять
очернить - очернять
притеснить - притеснять
стеснить - стеснять
стесниться - стесняться
оттеснить - оттеснять
вытеснить - вытеснять
вытесниться - вытесняться
пояснить - пояснять
прояснить - прояснять
проясниться - проясняться
уяснить - уяснять
объяснить - объяснять
объясниться - объясняться
разъяснить - разъяснять
разъясниться - разъясняться
изъяснить - изъяснять
изъясниться - изъясняться
выяснить - выяснять
выясниться - выясняться
подтрунить - подтрунивать
приструнить - приструнивать
уточнить - уточнять
уточниться - уточняться
одомашнить - одомашнивать
одомашниться - одомашниваться
подташнить - подташнивать
отлынить - отлынивать
увольнить - увольнять
увольниться - увольняться
подрумянить - подрумянивать
опьянить - опьянять
раздвоить - раздваивать
раздвоиться - раздваиваться
удвоить - удваивать
удвоиться - удваиваться
присвоить - присвоивать
присвоиться - присваиваться
освоить - осваивать
освоиться - осваиваться
усвоить - усвоивать
усвоиться - усваиваться
надоить - надаивать
обдоить - обдаивать
выдоить - выдаивать
успокоить - успокоивать
успокоиться - успокоиваться
запоить - запаивать
напоить - напаивать
выкроить - выкраивать
застроить - застраивать
застроиться - застраиваться
настроить - настраивать
настроиться - настраиваться
перенастроить - перенастраивать
обстроить - обстраивать
встроить - встраивать
встроиться - встраиваться
надстроить - надстраивать
подстроить - подстраивать
подстроиться - подстраиваться
перестроить - перестраивать
перестроиться - перестраиваться
пристроить - пристраивать
пристроиться - пристраиваться
достроить - достраивать
достроиться - достраиваться
расстроить - расстраивать
расстроиться - расстраиваться
отстроить - отстраивать
отстроиться - отстраиваться
устроить - устраивать
устроиться - устраиваться
обустроить - обустраивать
обустроиться - обустраиваться
переустроить - переустраивать
выстроить - выстраивать
выстроиться - выстраиваться
утроить - утраивать
застоить - застаивать
застоиться - застаиваться
настоить - настаивать
настоиться - настаиваться
удостоить - удостоивать
простоить - простаивать
отстоить - отстаивать
выстоить - выстаивать
запить - запивать
впить - впивать
впиться - впиваться
ослепить - ослеплять
перепить - перепивать
закрепить - закреплять
закрепиться - закрепляться
подкрепить - подкреплять
подкрепиться - подкрепляться
прикрепить - прикреплять
прикрепиться - прикрепляться
скрепить - скреплять
скрепиться - скрепляться
укрепить - укреплять
укрепиться - укрепляться
вцепить - вцеплять
вцепиться - вцепляться
сцепить - сцеплять
сцепиться - сцепляться
отцепить - отцеплять
допить - допивать
накопить - накапливать
накопиться - накапливаться
подкопить - подкапливать
скопить - скапливать
скопиться - скапливаться
попить - попивать
пропить - пропивать
затопить - затоплять
распить - распивать
испить - испивать
отпить - отпивать
закупить - закупать
закупиться - закупаться
подкупить - подкупать
окупить - окупать
окупиться - окупаться
покупить - покупать
покупиться - покупаться
скупить - скупать
раскупить - раскупать
раскупиться - раскупаться
искупить - искупать
искупиться - искупаться
выкупить - выкупать
выкупиться - выкупаться
притупить - притуплять
потупить - потуплять
заступить - заступать
заступиться - заступаться
наступить - наступать
обступить - обступать
вступить - вступать
вступиться - вступаться
подступить - подступать
переступить - переступать
преступить - преступать
приступить - приступать
поступить - поступать
поступиться - поступаться
проступить - проступать
расступить - расступать
расступиться - расступаться
отступить - отступать
отступиться - отступаться
уступить - уступать
выступить - выступать
выпить - выпивать
выпиться - выпиваться
усыпить - усыплять
растабарить - растабаривать
заварить - заваривать
завариться - завариваться
наварить - наваривать
обварить - обваривать
предварить - предварять
предвариться - предваряться
переварить - переваривать
разварить - разваривать
приварить - приваривать
подговарить - подговаривать
разговарить - разговаривать
поразговарить - поразговаривать
поуговарить - поуговаривать
доварить - доваривать
отоварить - отоваривать
отовариться - отовариваться
сварить - сваривать
уварить - уваривать
выварить - вываривать
раскочегарить - раскочегаривать
задарить - задаривать
раздарить - раздаривать
одарить - одаривать
ударить - ударять
удариться - ударяться
зажарить - зажаривать
зажариться - зажариваться
нажарить - нажаривать
обжарить - обжаривать
поджарить - поджаривать
поджариться - поджариваться
дожарить - дожаривать
прожарить - прожаривать
разбазарить - разбазаривать
озарить - озарять
озариться - озаряться
размарить - размаривать
вымарить - вымаривать
запарить - запаривать
пропарить - пропаривать
воспарить - воспарять
упарить - упаривать
ошпарить - ошпаривать
выпарить - выпаривать
выпариться - выпариваться
засахарить - засахаривать
засахариться - засахариваться
подсахарить - подсахаривать
осахарить - осахаривать
нашарить - нашаривать
обшарить - обшаривать
задабрить - задабривать
сдабрить - сдабривать
обрить - обривать
одобрить - одобрять
удобрить - удобрять
сбрить - сбривать
отбрить - отбривать
выбрить - выбривать
внедрить - внедрять
внедриться - внедряться
подбодрить - подбадривать
взбодрить - взбадривать
ободрить - ободрять
запудрить - запудривать
припудрить - припудривать
заверить - заверять
вверить - вверять
доверить - доверять
довериться - доверяться
поверить - поверять
проверить - проверять
провериться - проверяться
удостоверить - удостоверять
удостовериться - удостоверяться
сверить - сверять
свериться - сверяться
уверить - уверять
разуверить - разуверять
обмерить - обмеривать
размерить - размеривать
соразмерить - соразмерять
измерить - измерять
измериться - измеряться
примерить - примерять
примериться - примериваться
отмерить - отмерять
умерить - умерять
вымерить - вымерять
потерить - потерять
потериться - потеряться
растерить - растерять
растериться - растеряться
утерить - утерять
похерить - похеривать
вечерить - вечерять
заподозрить - заподазривать
растранжирить - растранжиривать
примирить - примирять
примириться - примиряться
утихомирить - утихомиривать
смирить - смирять
смириться - смиряться
усмирить - усмирять
расширить - расширять
расшириться - расширяться
водворить - водворять
заговорить - заговаривать
заговориться - заговариваться
наговорить - наговаривать
обговорить - обговаривать
переговорить - переговаривать
переговориться - переговариваться
приговорить - приговаривать
оговорить - оговаривать
оговориться - оговариваться
договорить - договаривать
договориться - договариваться
поговорить - поговаривать
проговорить - проговаривать
проговориться - проговариваться
отговорить - отговаривать
отговориться - отговариваться
уговорить - уговаривать
выговорить - выговаривать
выговориться - выговариваться
затворить - затворять
удовлетворить - удовлетворять
удовлетвориться - удовлетворяться
претворить - претворять
претвориться - претворяться
олицетворить - олицетворять
отворить - отваривать
отвориться - отворяться
оплодотворить - оплодотворять
умиротворить - умиротворять
сотворить - сотворять
растворить - растворять
раствориться - растворяться
вытворить - вытворять
подзадорить - подзадоривать
раззадорить - раззадоривать
разорить - разорять
разориться - разоряться
покорить - покорять
покориться - покоряться
укорить - укорять
заморить - замаривать
доспорить - доспоривать
закупорить - закупоривать
раскупорить - раскупоривать
откупорить - откупоривать
откупориться - откупориваться
укупорить - укупоривать
пришпорить - пришпоривать
засорить - засорять
повторить - повторять
повториться - повторяться
зашторить - зашторивать
выорить - выоривать
прить - привать
восприть - воспрять
обветрить - обветривать
обезветрить - обезветривать
проветрить - проветривать
выветрить - выветривать
выветриться - выветриваться
застрить - застрять
обострить - обострять
обостриться - обостряться
придурить - придуривать
придуриться - придуриваться
закурить - закуривать
подкурить - подкуривать
перекурить - перекуривать
прикурить - прикуривать
окурить - окуривать
докурить - докуривать
покурить - покуривать
прокурить - прокуривать
раскурить - раскуривать
выкурить - выкуривать
зажмурить - зажмуривать
зажмуриться - зажмуриваться
охмурить - охмурять
изнурить - изнурять
оштукатурить - оштукатуривать
доштукатурить - доштукатуривать
подхалтурить - подхалтуривать
прищурить - прищуривать
прищуриться - прищуриваться
возвихрить - взвихривать
поощрить - поощрять
поощриться - поощряться
подковырить - подковыривать
сковырить - сковыривать
расковырить - расковыривать
выковырить - выковыривать
запузырить - запузыривать
поднырить - подныривать
пронырить - проныривать
прошнырить - прошныривать
вынырить - выныривать
растопырить - растопыривать
оттопырить - оттопыривать
оттопыриться - оттопыриваться
притырить - притыривать
наярить - наяривать
окрасить - окрашивать
окраситься - окрашиваться
скрасить - скрашивать
раскрасить - раскрашивать
приукрасить - приукрашивать
подкосить - подкашивать
подкоситься - подкашиваться
скосить - скашивать
выкосить - выкашивать
носить - нашивать
износить - изнашивать
износиться - изнашиваться
доносить - донашивать
выносить - вынашивать
запросить - запрашивать
запроситься - запрашиваться
опросить - опрашивать
допросить - допрашивать
спросить - спрашивать
спроситься - спрашиваться
переспросить - переспрашивать
расспросить - расспрашивать
упросить - упрашивать
оплатить - оплачивать
оплатиться - оплачиваться
отплатить - отплачивать
уплатить - уплачивать
уплатиться - уплачиваться
выплатить - выплачивать
выплатиться - выплачиваться
превратить - превращать
превратиться - превращаться
развратить - развращать
извратить - извращать
возвратить - возвращать
возвратиться - возвращаться
совратить - совращать
отвратить - отвращать
сократить - сокращать
сократиться - сокращаться
затратить - затрачивать
затратиться - затрачиваться
растратить - растрачивать
истратить - истрачивать
утратить - утрачивать
утратиться - утрачиваться
заметить - замечать
заметиться - замечаться
наметить - намечать
наметиться - намечаться
подметить - подмечать
приметить - примечать
пометить - помечать
пометиться - помечаться
отметить - отмечать
отметиться - отмечаться
проспектить - проспективать
завинтить - завинчивать
завинтиться - завинчиваться
навинтить - навинчивать
ввинтить - ввинчивать
возвинтить - взвинчивать
свинтить - свинчивать
отвинтить - отвинчивать
вывинтить - вывинчивать
заколотить - заколачивать
вколотить - вколачивать
вколотиться - вколачиваться
приколотить - приколачивать
околотить - околачивать
околотиться - околачиваться
поколотить - поколачивать
сколотить - сколачивать
отколотить - отколачивать
уколотить - уколачивать
выколотить - выколачивать
сплотить - сплачивать
сплотиться - сплачиваться
наворотить - наворачивать
наворотиться - наворачиваться
поворотить - поворачивать
поворотиться - поворачиваться
своротить - сворачивать
своротиться - сворачиваться
укоротить - укорачивать
укоротиться - укорачиваться
заместить - замещать
заместиться - замещаться
вместить - вмещать
вместиться - вмещаться
переместить - перемещать
переместиться - перемещаться
разместить - размещать
разместиться - размещаться
возместить - возмещать
возместиться - возмещаться
поместить - помещать
поместиться - помещаться
сместить - смещать
сместиться - смещаться
уместить - умещать
уместиться - умещаться
выместить - вымещать
угостить - угащивать
запустить - запускать
запуститься - запускаться
напустить - напускать
впустить - впускать
подпустить - подпускать
опустить - опускать
опуститься - опускаться
допустить - допускать
допуститься - допускаться
пропустить - пропускать
пропуститься - пропускаться
спустить - спускать
спуститься - спускаться
распустить - распускать
распуститься - распускаться
испустить - испускать
отпустить - отпускать
отпуститься - отпускаться
упустить - упускать
выпустить - выпускать
выпуститься - выпускаться
прельстить - прельщать
прельститься - прельщаться
обольстить - обольщать
обольститься - обольщаться
почуить - почуять
заебачить - заебачивать
присобачить - присобачивать
озадачить - озадачивать
подщелачить - подщелачивать
выщелачить - выщелачивать
сволачить - сволачивать
обмолачить - обмолачивать
размолачить - размолачивать
переплачить - переплачивать
приплачить - приплачивать
доплачить - доплачивать
раскулачить - раскулачивать
размачить - размачивать
отмачить - отмачивать
взлохмачить - взлохмачивать
вымачить - вымачивать
вымачиться - вымачиваться
заначить - заначивать
подначить - подначивать
назначить - назначать
назначиться - назначаться
означить - означать
обозначить - обозначать
обозначиться - обозначаться
переиначить - переиначивать
околпачить - околпачивать
перелопачить - перелопачивать
задрачить - задрачивать
надрачить - надрачивать
оборачить - оборачивать
оборачиться - оборачиваться
заворачить - заворачивать
заворачиться - заворачиваться
обворачить - обворачивать
подворачить - подворачивать
подворачиться - подворачиваться
переворачить - переворачивать
переворачиться - переворачиваться
разворачить - разворачивать
разворачиться - разворачиваться
изворачить - изворачивать
изворачиться - изворачиваться
проворачить - проворачивать
проворачиться - проворачиваться
отворачить - отворачивать
отворачиться - отворачиваться
выворачить - выворачивать
выворачиться - выворачиваться
опорачить - опорачивать
приторачить - приторачивать
одурачить - одурачивать
обтачить - обтачивать
протачить - протачивать
стачить - стачивать
оттачить - оттачивать
оттачиться - оттачиваться
вытачить - вытачивать
увековечить - увековечивать
очеловечить - очеловечивать
расчеловечить - расчеловечивать
засвечить - засвечивать
подсвечить - подсвечивать
присвечить - присвечивать
освечить - освечивать
просвечить - просвечивать
отсвечить - отсвечивать
высвечить - высвечивать
высвечиться - высвечиваться
подцвечить - подцвечивать
расцвечить - расцвечивать
обесцвечить - обесцвечивать
отцвечить - отцвечивать
залечить - залечивать
подлечить - подлечивать
излечить - излечивать
долечить - долечивать
вылечить - вылечивать
опредмечить - опредмечивать
онемечить - онемечивать
онемечиться - онемечиваться
обеспечить - обеспечивать
обеспечиться - обеспечиваться
самообеспечить - самообеспечивать
обналичить - обналичивать
обличить - обличать
обличиться - обличаться
навеличить - навеличивать
возвеличить - возвеличивать
увеличить - увеличивать
увеличиться - увеличиваться
преувеличить - преувеличивать
различить - различать
различиться - различаться
обезличить - обезличивать
отличить - отличать
отличиться - отличаться
уличить - уличать
разграничить - разграничивать
ограничить - ограничивать
ограничиться - ограничиваться
отграничить - отграничивать
намагничить - намагничивать
подмагничить - подмагничивать
влажнонеустойчить - влажнонеустойчивать
умалчить - умалчивать
замолчить - замалчивать
замолчиться - замалчиваться
развенчить - развенчивать
увенчить - увенчивать
увенчиться - увенчиваться
закончить - заканчивать
закончиться - заканчиваться
прикончить - приканчивать
окончить - оканчивать
окончиться - оканчиваться
докончить - доканчивать
выклянчить - выклянчивать
озабочить - озабочивать
упорядочить - упорядочивать
пощекочить - пощекочивать
заскочить - заскакивать
наскочить - наскакивать
обскочить - обскакивать
вскочить - вскакивать
подскочить - подскакивать
перескочить - перескакивать
прискочить - прискакивать
доскочить - доскакивать
проскочить - проскакивать
соскочить - соскакивать
отскочить - отскакивать
выскочить - выскакивать
наблочить - наблочивать
замочить - замачивать
намочить - намачивать
уполномочить - уполномочивать
смочить - смачивать
смочиться - смачиваться
почить - почивать
започить - започивать
поотпочить - поотпочивать
опорочить - опорочивать
упрочить - упрочивать
просрочить - просрочивать
отсрочить - отсрочивать
приурочить - приурочивать
заточить - затачивать
наточить - натачивать
подточить - подтачивать
сосредоточить - сосредотачивать
сосредоточиться - сосредотачиваться
обесточить - обесточивать
докапчить - докапчивать
поварчить - поварчивать
верчить - верчивать
переверчить - переверчивать
очерчить - очерчивать
прочерчить - прочерчивать
расчерчить - расчерчивать
вычерчить - вычерчивать
заучить - заучивать
нахлобучить - нахлобучивать
озвучить - озвучивать
озвучиться - озвучиваться
переозвучить - переозвучивать
переучить - переучивать
переучиться - переучиваться
разучить - разучивать
окучить - окучивать
прокучить - прокучивать
наскучить - наскучивать
выкаблучить - выкаблучивать
доучить - доучивать
доучиться - доучиваться
выпучить - выпучивать
закручить - закручивать
закручиться - закручиваться
накручить - накручивать
вкручить - вкручивать
подкручить - подкручивать
перекручить - перекручивать
окручить - окручивать
покручить - покручивать
прокручить - прокручивать
скручить - скручивать
скручиться - скручиваться
раскручить - раскручивать
раскручиться - раскручиваться
откручить - откручивать
выкручить - выкручивать
выкручиться - выкручиваться
засучить - засучивать
всучить - всучивать
подсучить - подсучивать
отучить - отучивать
подшучить - подшучивать
вышучить - вышучивать
выучить - выучивать
закавычить - закавычивать
поклычить - поклычивать
заключить - заключать
заключиться - заключаться
включить - включать
включиться - включаться
подключить - подключать
подключиться - подключаться
переключить - переключать
переключиться - переключаться
исключить - исключать
исключиться - исключаться
отключить - отключать
отключиться - отключаться
выключить - выключать
выключиться - выключаться
скрючить - скрючивать
навьючить - навьючивать
выпячить - выпячивать
заквашить - заквашивать
зашить - зашивать
перекашить - перекашивать
окашить - окашивать
ошарашить - ошарашивать
закрашить - закрашивать
подкрашить - подкрашивать
перекрашить - перекрашивать
прикрашить - прикрашивать
докрашить - докрашивать
разукрашить - разукрашивать
разукрашиться - разукрашиваться
изукрашить - изукрашивать
охорашить - охорашивать
надопрашить - надопрашивать
пораспрашить - пораспрашивать
испрашить - испрашивать
поспрашить - поспрашивать
порасспрашить - порасспрашивать
выспрашить - выспрашивать
выпрашить - выпрашивать
обшить - обшивать
вшить - вшивать
подшить - подшивать
подбешить - подбешивать
выбешить - выбешивать
завешить - завешивать
навешить - навешивать
навешиться - навешиваться
занавешить - занавешивать
обвешить - обвешивать
подвешить - подвешивать
подвешиться - подвешиваться
перевешить - перевешивать
развешить - развешивать
возвешить - взвешивать
привешить - привешивать
уравновешить - уравновешивать
уравновешиться - уравновешиваться
провешить - провешивать
свешить - свешивать
свешиться - свешиваться
отвешить - отвешивать
увешить - увешивать
вывешить - вывешивать
вывешиться - вывешиваться
перешить - перешивать
разрешить - разрешать
разрешиться - разрешаться
отрешить - отрешать
отрешиться - отрешаться
пришить - пришивать
облапошить - облапошивать
взъерошить - взъерошивать
огорошить - огорошивать
прошить - прошивать
сшить - сшивать
сшиться - сшиваться
расшить - расшивать
отшить - отшивать
ушить - ушивать
отшелушить - отшелушивать
заслушить - заслушивать
заслушиться - заслушиваться
подслушить - подслушивать
дослушить - дослушивать
прослушить - прослушивать
прослушиться - прослушиваться
выслушить - выслушивать
выслушиться - выслушиваться
оглоушить - оглоушивать
нарушить - нарушать
нарушиться - нарушаться
обрушить - обрушивать
обрушиться - обрушиваться
разрушить - разрушать
разрушиться - разрушаться
засушить - засушивать
обсушить - обсушивать
подсушить - подсушивать
осушить - осушивать
досушить - досушивать
просушить - просушивать
высушить - высушивать
высушиться - высушиваться
вышить - вышивать
выхолащить - выхолащивать
подслащить - подслащивать
вымащить - вымащивать
усовещить - усовещивать
улещить - улещивать
закрещить - закрещивать
перекрещить - перекрещивать
скрещить - скрещивать
скрещиться - скрещиваться
перебарщить - перебарщивать
расплющить - расплющивать
заколоть - закалывать
наколоть - накалывать
вколоть - вкалывать
надколоть - надкалывать
подколоть - подкалывать
приколоть - прикалывать
поколоть - покалывать
проколоть - прокалывать
сколоть - скалывать
расколоть - раскалывать
расколоться - раскалываться
отколоть - откалывать
отколоться - откалываться
выколоть - выкалывать
закласть - закладывать
закласться - закладываться
накласть - накладывать
накласться - накладываться
обкласть - обкладывать
вкласть - вкладывать
вкласться - вкладываться
подкласть - подкладывать
подкласться - подкладываться
перекласть - перекладывать
перекласться - перекладываться
прикласть - прикладывать
прикласться - прикладываться
докласть - докладывать
докласться - докладываться
прокласть - прокладывать
прокласться - прокладываться
скласть - складывать
скласться - складываться
раскласть - раскладывать
раскласться - раскладываться
откласть - откладывать
откласться - откладываться
укласть - укладывать
укласться - укладываться
выкласть - выкладывать
выкласться - выкладываться
запасть - западать
напасть - нападать
впасть - впадать
подпасть - подпадать
перепасть - перепадать
припасть - припадать
опасть - опадать
попасть - попадать
попасться - попадаться
пропасть - пропадать
спасть - спадать
распасть - распадать
распасться - распадаться
отпасть - отпадать
выпасть - выпадать
заесть - заедать
обесть - обедать
весть - ведать
весться - ведаться
доесть - доедать
поесть - поедать
проесть - проедать
засесть - заседать
насесть - наседать
присесть - приседать
осесть - оседать
воссесть - восседать
учесть - учитывать
учесться - учитываться
разъесть - разъедать
съесть - съедать
задуть - задувать
обдуть - обдувать
поддуть - поддувать
раздуть - раздувать
раздуться - раздуваться
вздуть - вздувать
вздуться - вздуваться
продуть - продувать
сдуть - сдувать
отдуть - отдувать
отдуться - отдуваться
выдуть - выдувать
перешагнуть - перешагать
расстегнуть - расстегать
застигнуть - застигать
настигнуть - настигать
достигнуть - достигать
достигнуться - достигаться
постигнуть - постигать
вздрогнуть - вздрогать
перепрыгнуть - перепрыгать
исчезнуть - исчезать
ускользнуть - ускользать
разинуть - разиать
закинуть - закиать
прикинуть - прикиать
окинуть - окиать
покинуть - покиать
опрокинуть - опрокиать
преминуть - премиать
воскликнуть - воскликать
сникнуть - сникать
вскрикнуть - вскрикать
замкнуть - замыкать
замкнуться - замыкаться
примкнуть - примыкать
разомкнуть - размыкать
сомкнуть - смыкать
сомкнуться - смыкаться
заткнуть - затыкать
наткнуть - натыкать
наткнуться - натыкаться
воткнуть - втыкать
проткнуть - протыкать
уткнуть - утыкать
уткнуться - утыкаться
стукнуть - стукать
стукнуться - стукаться
привыкнуть - привыкать
вздремнуть - вздремать
потонуть - потопать
протонуть - протопать
утонуть - утопать
запнуть - запинать
запнуться - запинаться
захлопнуть - захлопать
распнуть - распинать
распнуться - распинаться
повернуть - поверать
зашвырнуть - зашвыривать
пошвырнуть - пошвыривать
расшвырнуть - расшвыривать
отшвырнуть - отшвыривать
вышвырнуть - вышвыривать
погаснуть - погасать
зависнуть - зависать
повиснуть - повисать
отвиснуть - отвисать
втиснуть - втисать
стиснуть - стисать
вспрыснуть - вспрысать
сглотнуть - сглотать
засунуть - засуать
запахнуть - запахать
распахнуть - распахать
свихнуть - свихать
задохнуть - задыхать
задохнуться - задыхаться
вдохнуть - вдыхать
вздохнуть - вздыхать
подохнуть - подыхать
отдохнуть - отдыхать
выдохнуть - выдыхать
выдохнуться - выдыхаться
засохнуть - засыхать
пересохнуть - пересыхать
просохнуть - просыхать
усохнуть - усыхать
высохнуть - высыхать
нахлынуть - нахлыать
вильнуть - вильать
заглянуть - загляать
взглянуть - взгляать
затянуть - затягивать
затянуться - затягиваться
натянуть - натягивать
натянуться - натягиваться
обтянуть - обтягивать
втянуть - втягивать
втянуться - втягиваться
подтянуть - подтягивать
подтянуться - подтягиваться
перетянуть - перетягивать
притянуть - притягивать
притянуться - притягиваться
дотянуть - дотягивать
дотянуться - дотягиваться
потянуть - потягивать
потянуться - потягиваться
протянуть - протягивать
стянуть - стягивать
стянуться - стягиваться
растянуть - растягивать
растянуться - растягиваться
оттянуть - оттягивать
оттянуться - оттягиваться
утянуть - утягивать
вытянуть - вытягивать
вытянуться - вытягиваться
быть - бывать
быться - бываться
забыть - забывать
забыться - забываться
перебыть - перебывать
пребыть - пребывать
избыть - избывать
прибыть - прибывать
добыть - добывать
добыться - добываться
побыть - побывать
сбыть - сбывать
сбыться - сбываться
отбыть - отбывать
отбыться - отбываться
убыть - убывать
выбыть - выбывать
завыть - завывать
подвыть - подвывать
возвыть - взвывать
заплыть - заплывать
наплыть - наплывать
вплыть - вплывать
подплыть - подплывать
переплыть - переплывать
приплыть - приплывать
оплыть - оплывать
доплыть - доплывать
проплыть - проплывать
сплыть - сплывать
сплыться - сплываться
расплыть - расплывать
расплыться - расплываться
всплыть - всплывать
отплыть - отплывать
уплыть - уплывать
выплыть - выплывать
замыть - замывать
намыть - намывать
обмыть - обмывать
подмыть - подмывать
подмыться - подмываться
перемыть - перемывать
размыть - размывать
размыться - размываться
взмыть - взмывать
измыть - измывать
измыться - измываться
омыть - омывать
омыться - омываться
домыть - домывать
промыть - промывать
смыть - смывать
смыться - смываться
отмыть - отмывать
умыть - умывать
умыться - умываться
вымыть - вымывать
изныть - изнывать
уныть - унывать
закрыть - закрывать
закрыться - закрываться
накрыть - накрывать
накрыться - накрываться
перекрыть - перекрывать
перекрыться - перекрываться
прикрыть - прикрывать
прикрыться - прикрываться
покрыть - покрывать
покрыться - покрываться
сокрыть - сокрывать
скрыть - скрывать
скрыться - скрываться
раскрыть - раскрывать
раскрыться - раскрываться
вскрыть - вскрывать
вскрыться - вскрываться
открыть - открывать
открыться - открываться
укрыть - укрывать
укрыться - укрываться
застыть - застывать
остыть - остывать
выстыть - выстывать
навеять - навевать
развеять - развевать
развеяться - развеваться
насеять - насеивать
посеять - посеивать
рассеять - рассеивать
рассеяться - рассеиваться
взять - брать
взяться - браться
подмять - подминать
перемять - переминать
перемяться - переминаться
размять - разминать
размяться - разминаться
помять - поминать
помяться - поминаться
смять - сминать
занять - занимать
заняться - заниматься
нанять - нанимать
наняться - наниматься
обнять - обнимать
обняться - обниматься
внять - внимать
подровнять - подравнивать
разровнять - разравнивать
прировнять - приравнивать
прировняться - приравниваться
сровнять - сравнивать
сровняться - сравниваться
уровнять - уравнивать
уровняться - уравниваться
выровнять - выравнивать
выровняться - выравниваться
поднять - поднимать
подняться - подниматься
перенять - перенимать
переняться - перениматься
разнять - разнимать
принять - принимать
приняться - приниматься
обонять - обонимать
подвонять - подванивать
повонять - пованивать
донять - донимать
понять - понимать
поняться - пониматься
снять - снимать
сняться - сниматься
отнять - отнимать
отняться - отниматься
унять - унимать
уняться - униматься
вынять - вынимать
зажечь - зажигать
зажечься - зажигаться
обжечь - обжигать
обжечься - обжигаться
поджечь - поджигать
поджечься - поджигаться
разжечь - разжигать
разжечься - разжигаться
возжечь - возжигать
прижечь - прижигать
прожечь - прожигать
сжечь - сжигать
сжечься - сжигаться
выжечь - выжигать
завлечь - завлекать
навлечь - навлекать
развлечь - развлекать
развлечься - развлекаться
извлечь - извлекать
извлечься - извлекаться
привлечь - привлекать
привлечься - привлекаться
отвлечь - отвлекать
отвлечься - отвлекаться
увлечь - увлекать
увлечься - увлекаться
запечь - запекать
опечь - опекать
допечь - допекать
выпечь - выпекать
обречь - обрекать
предречь - предрекать
приберечь - приберегать
оберечь - оберегать
сберечь - сберегать
подстеречь - подстерегать
остеречь - остерегать
остеречься - остерегаться
изречь - изрекать
отречь - отрекать
отречься - отрекаться
засечь - засекать
подсечь - подсекать
пересечь - пересекать
пересечься - пересекаться
пресечь - пресекать
пресечься - пресекаться
рассечь - рассекать
отсечь - отсекать
высечь - высекать
заволочь - заволакивать
заволочься - заволакиваться
обволочь - обволакивать
подволочь - подволакивать
приволочь - приволакивать
доволочь - доволакивать
уволочь - уволакивать
выволочь - выволакивать
запрячь - запрягать
запрячься - запрягаться
напрячь - напрягать
напрячься - напрягаться
впрячь - впрягать
спрячь - спрягать
спрячься - спрягаться
распрячь - распрягать